XXXXXXXXXXXXXXXXXXXX
XEXEXEXEXXXEXEXEXEXX
XEEEEEEEEXEEEEEEEEEX
XEEEEEEEEXEEEEEEEEEX
XEEEEEEEEXEEEEEEEEEX
XEEEEEEXXoXXEEEEEEEX
XEEEEEXoo3ooXEEEEEEX
XEEXXEoooooooEXXEEEX
XXXEEEoooooooEEEXXEX
XEEEEEEERRREEEEEEEXX
XEEEEEEERRREEEEEEEEX
XEEEEEEERRREEEEEEEEX
XEEEEEEERRREEEEEEEEX
XEEEEEEERRREEEEEEEEX
XEEEEEEERRREEEEEEEEX
XEEEEEEERRREEEEEEEEX
XEEEEEEERRREEEEEEEEX
XEEEEEEE12REEEEEEEEX
XXEXEXEERRREEXEXEXXX
XXXXXXXERRREXXXXXXXX
